溈	潙
床	牀
蒍	蔿
稜	棱
群	羣
鯰	鮎
洩	泄
抬	擡
媯	嬀
麵	麪
踴	踊
簷	檐
為	爲
床	牀
粽	糉
眾	衆
韁	繮
潀	潨
晒	曬
汙	污
啟	啓
裡	裏
湧	涌
缽	鉢
睪	睾
峰	峯
痴	癡
灶	竈
嫻	嫺
痺	痹
偽	僞
唇	脣
么	幺
秘	祕
--顎	齶 顎
--核	覈 核
--凶	兇 凶
--才	纔 才
--著	着 著
--參	蔘 參
--針	鍼 針
